0,0,0,0,0,0,0,0,0,0,0,0,0,0,0,0,0,0,0,0,0,0,0,0,0,0,0,0
0,0,0,0,0,0,0,0,0,0,0,0,0,0,0,0,0,0,0,0,0,0,0,0,0,0,0,0
0,0,0,0,0,0,0,0,24,0,0,0,0,0,0,0,0,0,0,0,0,0,0,0,0,0,0,0
0,0,0,0,0,0,0,0,24,24,0,0,0,0,0,0,0,0,0,0,0,0,0,0,0,0,0,0
0,0,0,0,0,0,0,24,24,24,24,0,0,0,0,0,25,0,0,0,0,0,0,0,0,0,0,0
0,0,0,0,0,0,24,24,25,25,25,0,0,25,25,25,25,25,0,0,0,0,0,0,0,0,0,0
0,0,0,0,0,24,24,24,24,25,25,0,25,25,25,25,25,25,25,25,0,0,0,0,0,0,0,0
0,0,0,0,0,24,24,24,24,25,25,0,25,25,25,25,25,25,25,25,25,0,0,0,0,0,0,0
0,0,0,0,0,24,24,24,24,25,25,25,25,0,0,25,25,0,25,25,25,25,0,0,0,0,0,0
0,0,0,0,0,24,24,24,24,24,25,25,25,0,0,0,0,0,0,25,25,25,0,0,0,0,0,0
0,0,0,0,0,24,24,24,24,0,0,25,25,0,0,0,0,0,0,25,25,25,0,0,0,0,0,0
0,0,0,0,0,24,24,0,0,0,0,25,25,25,0,0,0,0,0,25,25,25,25,0,0,0,0,0
0,0,0,0,24,24,24,24,0,0,0,25,25,25,0,0,0,0,25,25,25,25,25,25,0,0,0,0
0,0,0,24,24,24,24,24,24,0,0,25,25,25,25,25,0,0,25,25,25,25,25,25,25,0,0,0
0,0,0,24,24,24,24,24,24,0,0,0,25,25,25,25,0,25,25,25,25,0,25,25,25,0,0,0
0,0,0,24,24,24,24,24,24,0,0,0,0,25,24,24,24,25,25,25,0,0,0,25,25,25,0,0
0,0,0,24,24,24,24,24,0,0,0,0,0,0,25,24,24,25,25,25,0,0,0,25,25,25,0,0
0,0,0,24,24,24,24,0,0,0,0,0,0,0,0,24,24,24,25,0,0,0,0,25,25,25,0,0
0,0,0,24,24,0,0,0,0,0,0,0,0,0,0,24,24,24,25,0,0,0,0,25,25,25,0,0
0,0,0,0,0,0,0,0,0,0,0,0,0,24,24,24,24,24,25,0,0,0,0,25,25,25,0,0
0,0,0,0,0,0,0,0,0,0,0,24,24,24,24,24,24,24,25,25,0,0,25,25,25,0,0,0
0,0,0,0,0,0,0,0,0,0,24,24,24,24,24,24,24,25,25,25,25,25,25,25,25,0,0,0
0,0,0,0,0,0,0,0,0,24,24,24,24,24,24,24,0,0,25,25,25,25,25,25,25,0,0,0
0,0,0,0,0,0,0,0,24,24,24,24,24,24,24,24,0,0,0,25,25,25,24,25,0,0,0,0
0,0,0,0,0,0,0,0,24,24,24,24,24,24,24,24,0,0,0,25,25,24,24,24,0,0,0,0
0,0,0,0,0,0,0,0,24,24,24,24,24,24,24,0,0,0,0,0,24,24,24,24,0,0,0,0
0,0,0,0,0,0,0,0,0,24,24,24,24,0,0,0,0,0,0,0,0,24,24,0,0,0,0,0
0,0,0,0,0,0,0,0,0,0,24,24,0,0,0,0,0,0,0,0,0,0,0,0,0,0,0,0
0,0,0,0,0,0,0,0,0,0,0,0,0,0,0,0,0,0,0,0,0,0,0,0,0,0,0,0
0,0,0,0,0,0,0,0,0,0,0,0,0,0,0,0,0,0,0,0,0,0,0,0,0,0,0,0
0,0,0,0,0,0,0,0,0,0,0,0,0,0,0,0,0,0,0,0,0,0,0,0,0,0,0,0
0,0,0,0,0,0,0,0,0,0,0,0,0,0,0,0,0,0,0,0,0,0,0,0,0,0,0,0
0,0,0,0,0,0,0,0,0,0,0,0,0,0,0,0,0,0,0,0,0,0,0,0,0,0,0,0
0,0,0,0,0,0,0,0,0,0,0,0,0,0,0,0,0,0,0,0,0,0,0,0,0,0,0,0
0,0,0,0,0,0,0,0,0,0,0,0,0,0,0,0,0,0,0,0,0,0,0,0,0,0,0,0
0,0,0,0,0,0,0,0,0,0,0,0,0,0,0,0,0,0,0,0,0,0,0,0,0,0,0,0
0,0,0,0,0,0,0,0,0,0,0,0,0,0,0,0,0,0,0,0,0,0,0,0,0,0,0,0
0,0,0,0,0,0,0,0,0,0,0,0,0,0,0,0,0,0,0,0,0,0,0,0,0,0,0,0
0,0,0,0,0,0,0,0,0,0,0,0,0,0,0,0,0,0,0,0,0,0,0,0,0,0,0,0
0,0,0,0,0,0,0,0,0,0,0,0,0,0,0,0,0,0,0,0,0,0,0,0,0,0,0,0
0,0,0,0,0,0,0,0,0,0,0,0,0,0,0,0,0,0,0,0,0,0,0,0,0,0,0,0
0,0,0,0,0,0,0,0,0,0,0,0,0,0,0,0,0,0,0,0,0,0,0,0,0,0,0,0
0,0,0,0,0,0,0,0,0,0,0,0,0,0,0,0,0,0,0,0,0,0,0,0,0,0,0,0
0,0,0,0,0,0,0,0,0,0,0,0,0,0,0,0,0,0,0,0,0,0,0,0,0,0,0,0
0,0,0,0,0,0,0,0,0,0,0,0,0,0,0,0,0,0,0,0,0,0,0,0,0,0,0,0
0,0,0,0,0,0,0,0,0,0,0,0,0,0,0,0,0,0,0,0,0,0,0,0,0,0,0,0